EA textures/cib.png
NO textures/cor.png
SO textures/vin.png
WE textures/obs.png

F 164,169,20
C 153,204,255

111111111111111111111
101W00001000000000001
101010101011111110001
100010100010000010001
111111111111111111111
